--//--//--
-        -
-        -
p        p
----------
-        -
l        t
-        -
---£--$---

Salad

2 1
2 7
4 4
4 7