stock 10

----lto---
-        -
-        -
----------
-        -
/        /
-        -
----------
-        -
p        p
-        -
---£--$---

Salad

teams
3 1
6 1
3 5
6 5
3 9
6 9

