stock 3

--£---$---
-   --   -
#   --   #
----------
l        t
-        -
-        -
/        /
---p--p---

Salad

teams
3 1
6 1
3 7
6 7
3 4
6 4
3 5
6 5
