stock 3

--//--//--
-   --   -
-   --   -
p   --   p
----------
-        #
l        t
-        -
---£--$---

Salad

teams
3 1
6 1
3 7
6 7
3 3
6 3
3 5
6 5
